xrange_bot,xrange_top,yrange_bot,yrange_top,stamp_xcor,stamp_ycor,x_stretch,y_stretch,
-180,-20,-170,-150,-100,-160,8,1
-38,2,-115,-95,-18,-105,2,1
-93,-53,-41,-21,-74,-45,2,1
-43,-3,30,50,-73,-31,2,1
-102,-62,102,122,-23,40,2,1
21,301,131,151,-82,112,2,1
